#################
#D###############
# ###############
# ###############
#            2###
# ###############
# ###############
# ###############
# ###############
# ###############
#1###############
#################
---
visible_range=10
---
D D door index to_doors
1 D door room1 from_doors_to_room1
2 D door room2 from_doors_to_room2