#################
#A###############
# ###############
# ###############
#            B###
# ###############
# ###############
# ###############
# ###############
# ###############
#C###############
#################
---
visible_range=10
---
A D door index to_doors
B D door room2 from_doors_to_room2
C D door room1 from_doors_to_room1