#############################################################
##                                                         ##
##     ##    #    #   ##    #                     #        ##
##     # #  # #  # #  # #  #                      ###      ##
##     # #  # #  # #  ##    #              ###########     A#
##     # #  # #  # #  # #    #                    ###      ##
##     ##    #    #   # #   #                     #        ##
##                                                         ##
##                                                         ##
##      ##  # #  ###   #   ###   #                #        ##
##     #    # #  #    #     #   #                 ###      ##
#B @   #    ###  ###   #    #    #         ###########     C#
##     #    # #  #      #   #     #               ###      ##
##      ##  # #  ###   #    #    #                #        ##
##                                                         ##
##                                                         ##
##     ##   #     #   ###  ###   #                #        ##
##     # #  #    # #   #   #    #                 ###      ##
##     ##   #    ###   #   ###   #         ###########     D#
##     #    #    # #   #   #      #               ###      ##
##     #    ###  # #   #   ###   #                #        ##
##                                                         ##
##                                                         ##
##     ###   #   ##    ##  # #  ###   #           #        ##
##      #   # #  # #  #    # #  #    #            ###      ##
##      #   # #  ##   #    ###  ###   #    ###########     E#
##      #   # #  # #  #    # #  #      #          ###      ##
##      #    #   # #   ##  # #  ###   #           #        ##
##                                                         ##
##                                                         ##
#############################################################
---
visible_range=20
---
A D door doors to_doors
B D door test testing
C D door chests to_chests
D D door hidden_walls to_hidden_walls
E D door torches to_torches