#############################################################
##                                                         ##
##     ##    #    #   ##    #                     #        ##
##     # #  # #  # #  # #  #                      ###      ##
##     # #  # #  # #  ##    #              ###########     1#
##     # #  # #  # #  # #    #                    ###      ##
##     ##    #    #   # #   #                     #        ##
##                                                         ##
##                                                         ##
##      ##  # #  ###   #   ###   #                #        ##
##     #    # #  #    #     #   #                 ###      ##
#E @   #    ###  ###   #    #    #         ###########     2#
##     #    # #  #      #   #     #               ###      ##
##      ##  # #  ###   #    #    #                #        ##
##                                                         ##
##                                                         ##
##     ##   #     #   ###  ###   #                #        ##
##     # #  #    # #   #   #    #                 ###      ##
##     ##   #    ###   #   ###   #         ###########     3#
##     #    #    # #   #   #      #               ###      ##
##     #    ###  # #   #   ###   #                #        ##
##                                                         ##
##                                                         ##
##     ###   #   ##    ##  # #  ###   #           #        ##
##      #   # #  # #  #    # #  #    #            ###      ##
##      #   # #  ##   #    ###  ###   #    ###########     4#
##      #   # #  # #  #    # #  #      #          ###      ##
##      #    #   # #   ##  # #  ###   #           #        ##
##                                                         ##
##                                                         ##
#############################################################
---
visible_range=20
---
E D door test testing
1 D door doors to_doors
2 D door chests to_chests
3 D door hidden_walls to_hidden_walls
4 D door torches to_torches