#######################################################
#                                                    ##
#     ##    #    #   ##    #                #        ##
#     # #  # #  # #  # #  #                 ###      ##
#     # #  # #  # #  ##    #         ###########     1#
#     # #  # #  # #  # #    #               ###      ##
#     ##    #    #   #  #  #                #        ##
#                                                    ##
#                                                    ##
#       #  # #  ###   #   ###   #           #        ##
#     #    # #  #    #     #   #            ###      ##
# @   #    ###  ###   #    #    #    ###########     2#
#     #    # #  #      #   #     #          ###      ##
#       #  # #  ###   #    #    #           #        ##
#                                                    ##
#                                                    ##
#     ##   #     #   ###  ###   #          #         ##
#     # #  #    # #   #   #    #           ###       ##
#     ##   #    ###   #   ###   #    ###########     3#
#     #    #    # #   #   #      #         ###       ##
#     #    ###  # #   #   ###   #          #         ##
#                                                    ##
#######################################################
---
1 D door doors to_doors
2 D door chests to_chests
3 D door hidden_walls to_hidden_walls