############
#         ##
#    @    1#
#         ##
############
---
1 door map2