###########
2         3
##### #####
##### #####
##### #####
##### #####
##### #####
##### #####
##### #####
#####1#####
---
1-map1
2-map3
3-map4