########
2      #
#      #
#      #
#      #
########
---
2-map2