##########
#        #
#        #
#        #
#       A#
#        #
#        #
#        #
#        #
##########
---
visible_range=10
---
A D door index testing
---
