####################
#A                ##
#                 ##
#                 ##
#B           C    D#
#                 ##
#                 ##
#                 ##
#E                ##
####################
---
visible_range=5
---
A # hidden_tile s I torch 5
B # hidden_tile s D door test1 testing1
C _ pressure_plate s
D D door index testing
E # hidden_tile s I torch 5