####################################
##                                 #
#D          I          I          I#
##                                 #
####################################
---
visible_range=5
---
D D door index to_torches
I I torch 5
---
